111111
111121
122221
121111
122231
111111